S110000000000000
1111011111101110
1001010000101010
1011010111101010
1010010000101010
1011111010101010
1000001010101010
1111101010101010
1000101010001010
1011101011111010
1010001010000010
1010111010111110
1010000010100011
1011111110101111
100000000010000E
